1 1 _ _ _ 1 1 1 0 1 
1 f 0 1 1 1 1 1 0 1 
1 0 0 1 0 0 0 0 0 1 
1 1 1 1 1 1 1 1 0 1 
0 1 1 1 p s 0 0 0 0
0 1 0 1 s t4.1 1 1 1 1 
0 1 1 1 0 1 1 1 t4.2 0 
0 1 1 1 0 1 1 1 1 1 
0 0 0 0 0 0 0 0 0 0 
1 1 1 1 0 1 1 1 0 1 
