1 1 t3.1 1 0 1 1 0 _ f
1 1 1 1 0 0 0 0 1 1
0 0 0 0 1 0 0 1 0 0
0 1 0 0 0 0 1 0 0 1
1 0 1 0 1 0 1 1 0 0
0 0 0 1 1 0 0 0 0 1
1 0 1 0 0 1 1 1 0 0
0 0 0 0 0 0 0 0 0 1
0 0 1 1 0 0 0 1 s 1
1 0 0 1 0 1 0 1 p 1 
